Rihanna - Lift Me Up
Sam Smith, Kim Petras - Unholy
Miley Cyrus - Flowers
Karol G ft. Shakira - TQG
Pink - TRUSTFALL
Ed Sheeran, Pokémon - Celestial
Måneskin - THE LONELIEST
Kendji Girac et Vianney - Le Feu
Vianney ft. Ed Sheeran - Call On Me
Benson Boone & Philippine Lavrey - In The Stars (French Version)
Lil Nas X - STAR WALKIN' (League of Legends Worlds Anthem)
Dermot Kennedy - Kiss Me
Calvin Harris - Miracle ft Ellie Goulding
Loreen - Tattoo (Eurovision 2023)
The Weeknd - Creepin' ft. Metro Boomin & 21 Savage
Taylor Swift - Anti-Hero
David Guetta & Bebe Rexha - I'm Good (Blue)
Ridsa - Nous deux
Calema - Te Amo (remix)
Pierre de Maere - Un jour je marierai un ange
Ofenbach - Love Me Now ft. Fast Boy
Beyoncé - CUFF IT
Soprano - 3615 Bonheur
Rosa Linn - Snap
KAROL G ft. Ovy On The Drums - Cairo
Ayra Starr - Rush
Dadju ft. PLK - Saigne
Shakira - BZRP ft. Bizarrap
Libianca - People (Check On Me)
Slimane - Des milliers de je t’aime
David Guetta, Anne-Marie, Coi Leray - Baby Don’t Hurt Me (reprise Haddaway)
Louane - Secret
Rosalía - Despechá
Lizzo - 2 Be Loved (Am I Ready)
Aime Simone - Shining Light (musique PUB Leroy Merlin)
Ed Sheeran - Eyes Closed
Central Cee - Let Go (reprise Let Her Go de Passenger)
Joel Corry & Tom Grennan - Lionheart (Fearless)
CKay - Love Nwantiti (Ah Ah Ah) Remix
David Kushner - Daylight
Black Eyed Peas, Shakira, David Guetta - DON'T YOU WORRY
M. Pokora - Déjà Volé
Adele - Easy On Me
SHOUSE - Won't Forget You
Coldplay ft. Selena Gomez - Let Somebody Go
Ridsa - Santa Maria
Kendji Girac - Eva
Oliver Tree & Robin Schulz - Miss You
Harry Styles - Late Night Talking
Gims ft. Soolking - Après Vous Madame
